11111111111111
100C1000000001
1001100001E001
11000010000001
1P0000100011C1
11111111111111