11111111111111
100C1000000000
1001100001E001
11000010000001
1P000010011C11
11111111111111